{
  "Ё": "E",
  "Й": "N",
  "Ц": "T",
  "У": "y",
  "К": "K",
  "Е": "E",
  "Н": "H",
  "Г": "T",
  "Ш": "W",
  "Щ": "W",
  "З": "3",
  "Х": "X",
  "Ъ": "b",
  "ё": "e",
  "й": "n",
  "ц": "u",
  "у": "y",
  "к": "k",
  "е": "e",
  "н": "H",
  "г": "r",
  "ш": "w",
  "щ": "w",
  "з": "3",
  "х": "x",
  "ъ": "b",
  "Ф": "o",
  "Ы": "bl",
  "В": "b",
  "А": "А",
  "П": "N",
  "Р": "P",
  "О": "O",
  "Л": "N",
  "Д": "A",
  "Ж": "X",
  "Э": "3",
  "ф": "o",
  "ы": "bl",
  "в": "B",
  "а": "a",
  "п": "n",
  "р": "p",
  "о": "o",
  "л": "n",
  "д": "A",
  "ж": "x",
  "э": "3",
  "Я": "R",
  "Ч": "4",
  "С": "C",
  "М": "M",
  "И": "N",
  "Т": "T",
  "Ь": "b",
  "Б": "b",
  "Ю": "lo",
  "я": "R",
  "ч": "4",
  "с": "c",
  "м": "m",
  "и": "n",
  "т": "T",
  "ь": "b",
  "б": "b",
  "ю": "lo",
  "Є": "E",
  "є": "E",
  "Ι": "I",
  "ι": "I"
}
